oooooooooooooooooooooooooooooooo
00L000000jk0000000000jk00UU00000
00P000000jk0000000000jk000000000
ffi000hffjk000hffhi00jk000000000
""k000000jk000000jk00jk00000000h
""k000000jk000000jk00jk00000000j
""kffi000jkffi000jk00jk00000000j
""k000000jk000000jk00jk000hi000j
""k000000jk000000jk00jk000lm000j
""k000hffjk000hffjk00jk00000000j
""k000000jk000000jk00jk00000000j
""k000000jk000000jk00jk00000000j
""kffi000jkffi000jk00jk00000000j
""k000000jk000000jk00jk000hi000j
""k000000jk000000jk00jk000lm000j
""k000hffjk000hffjk00jk00000000j
""k000000jk000000jk00jk00000000j
""k000000jk000000jk00jk00000000j
""kffi000jkffi000jk00hffffi0000j
""k000000lm000000jk00lnnnnm0000j
""k00000000000000jk000U00U00000j
""k00000000000000jk000000000000j
nnm00000000000000jk000000000000j
000000000hffffffffffi000000hfffl,50,75
