oooooooooooooooooooooooooooooooo
00L000000jk0000000000jk00UU00000
00P000000jk0000000000jk000000000
ffi000hffjk000hffhi00jk000000000
00k000000jk000000jk00jk00000000j
00k000000jk000000jk00jk00000hi0j
00kffi000jkffi000jk00jk00000lm0j
00k000000jk000000jk00jk00000000j
00k000000jk000000jk00jk0hi00000j
00k000hffjk000hffjk00jk0lm00000j
00k000000jk000000jk00jk00000000j
00k000000jk000000jk00jk00000000j
00kffi000jkffi000jk00jk00000000j
00k000000jk000000jk00jk0000hi00j
00k000000jk000000jk00jk0000lm00j
00k000hffjk000hffjk00jk00000000j
00k000000jk000000jk00jk00000000j
00k000000jk000000jk00jk00000000j
00kffi000jkffi000jk00hffffi0000j
00k000000lm000000jk00lnnnnm0000j
00k00000000000000jk000U00U00000j
00k00000000000000jk000000000000j
nnm00000000000000jk000000000000j
000000000hffffffffffi000000hfffl,50,75
