oooooooooooooooooooooooooooooooo
k0000000000000000000000000000000
k0000000000000000000000000000000
k0000000000000000000000000000000
k000011111111111111111111140000h
k000000000000000000000000560000j
k000000000000000000000000560000j
k111111111111111111110000560000j
k000000000000000000000000560000j
k000000000000000000000000560000j
k000011111111111111111111560000j
k000000000000000000000000560000j
k000000000000000000000000560000j
k111111111111111111110000560000j
k000000000000000000000000560000j
k000000000000000000000000560000j
k000011111111111111111111560000j
k000000000000000000000000560000j
k000000000000000000000000560000j
8111111111111111111110000780000j
0000000000000000000000000000000j
0000000000000000000000000000000j
1111111111111111111111111400000j
0000000000000000000000000600000j
