oooooooooooooooooooooooooooooooo
60000000000000000000000000000000
60000000000000000000000000000000
14000003111111111111111111111111
08000007999999999999999999999999
08000000000000000000000000000005
08000000000000000000000000000005s
08000000000000000000000000000005
01111111111111111111114000001111
00000000000000000000006000000000
00000000000000000000006000000000
00000000000000000000006000000000
00000000000000000000006000000000
09999999999999999999998000000003
c0000000000000000000000000000005
00000000000000000000000000000005
00000000000000000000000000000005
00000000000000000000000000000005
40000000000000000000000000000311
60000000000000000000000000000500
60000000000000000000000000000500
11140000000000000000000031111100
00060000000000000000000050000000
00060000000000000000000050000000
