"""w0000000000000000000000000000
"""w0000000000R00000000000000000
"""w00000000000000000K0000000000
"""wO0000000K0000R0000000000000~
"""ws00000000000000000000000000~
"""w000000000000000000000hi00hff
"""w000000R00000000000000jk00j00
"""w000000000000000K00000jk00j00
"""w000000000000000000000lm00j00
"""w000000R00000000000000V000j00
"""w0000000000000000000000000j00
"""w0000000000000000000000000j00
"""w0000000000000000000000000j00
"""w00000000000000000hfffi000j00
"""w00000000000000000looom000j00
"""w00000000000000000U00U0000j00
"""w0000000000000hi0000000000j00
"""w0000000000000lm0000000000j00
"""w00000000S00S00U0000000000j00
zzzy000000hfffffi000000000000j00
0000000000j00000k000000000000j00
0000000000j00000k000000000000j00
sssssu0000j00000k^^^^^^^^^^^^j00
"""""w0000j00000k````````````j00,30,700
