00000000000000000000000000000000
00X00000000X00000000X000000X0L~X
00X00000000X00000000X000000X0P~X
00X00000000X00000000X00Z"Y0tssss
00X00000000X00000000X00YZY0v""""
00X00000000X000L0000X000000v""""
00X00Y!Z000X000P0000X000000v""""
00X00$$Z000X00000000X000000v""""
00X0Z$#Y000X00000000X000000v""""
00X0Z00Z000X000000tsssu0000v""""
00X00000000X000000v"""w0000v""""
00X000L0000X000000v"""w0000v""""
00X00JP0000X000000v"""w0000v""""
00X00000000X000000v"""w0000v""""
00X00000000X000000v"""w0000v""""
00X000000tsssu0000v"""w0Z"0v""""
00X0J00N0v"""w0ZZ0v"""w0Y"Yv""""
00X000000v"""wZY00v"""w000Yv""""
00X000000v"""w0YZ0v"""w0000v""""
00X000000v"""w0000v"""w0000v""""
00X000000v"""w0000v"""w0000v""""
ssssu0000v"""w0000v"""w0000v""""
""""y00Q0v"""w0000v"""w0000v""""
""""y____v"""w____v"""w____v"""",30,600
