00000000000000000000000000000000
00000000000000000000000000O00000
00000000000000000000000000tu0tu0
00000000000000000000000000vwzvwz
00000000000000000000000000v"""""
00000000000000000000000000v"""""
0000000000K000000000000000v"""""
00000000000000000000000000v"tsu"
00000000000000000000000000v"vOw"
0000000000000000R000000000v"sss"
000R0000000000000000000000v"""""
00000000000000000000000000v"""""
00000000000000000000000000v"""""
00000000000000000000000000v"""""
00000000000000000000000000rrrvL"
00000000000000000000000000000vP"
00000000000000000000000000000v""
00000000000000000000WW00tsssssss
00000000000000000003111111111111
00000000000000000005000000000000
00W00W000W00W0000005000000000000
11111111111114000005000000000000
00000000000006^^^^^5000000000000
00000000000006`````5000000000000,30,700
