wzzzzzzzzzzzzzzzz0zzzzzzzzzzzzzv
w______________________________v
w_0000000000000000000000000000~v
w_0000000000000000000000000000~v
w_0000000000000000000000000000~v
w_0000000000000000000000000000~v
w_0000_________________________v
w_0000_________________________v
w_0000_________________________v
w_0000__________00000000000000_v
w_0000__________00000000000000_v
w_0000__________00000000000000_v
w_0000__________00000000000000_v
w_0000__________0000______0000_v
w_000000000000000000______0000_v
w_000000000000000000______0000_v
w_000000000000000000______0000_v
w_000000000000000000______0000_v
w_________________________0000_v
000000000000000000000000000000_v
000000000000000000000000000000_v
000000000000000000000000000000_v
000000000000000000000000000000_v
rssssss________________________v,20,700,0
