wzzzzzzzzzzzzzzzzzzzzzzzzzzzzzzv
_______________________________v
00000000000000000000000000_____v
00000000000000000000000000_____v
00000000000000000000000000_____v
00000000000000000000000000_____v
________________0000000000_____v
v_______________0000000000_____v
v_______________0000000000_____v
v_______________0000000000_____v
v______________00000000000_____v
v____________0000000000000_____v
v__________000000000000000_____v
v________00000000000000000_____v
v______000000000000000000______v
v____00000000000000000_________v
v__000000000000000_________000_v
v_000000000000___________00000_v
v_0000000___________000000000000
v_0000000______00000000000000000
v_000000000000000000000000000000
v_000000000000000000000000000000
v_000000000000000000000000000000
_________________________rrrrrrr,20,150
