00000000R0500000000600000000000~
000000K0005Y00$00$Y600000000000~
0000O00000500000000600000000000~
1111400000500$0000!600000000000~
00006000005000000006000000311111
0Y0!6000005Y000Z0$06000000500$00
0000600L0050000000!60000005000$0
0$00600P00500$00$00600000050$000
Z00!6000005Y00Z0!00600000T500!Y0
0000600000500000!006000000500$00
00!06000005!0$0000Y600000050$000
Z00!600L00500!00Z006000000500Y$0
00Z0600P0050$000!006000000500000
000$6000005000!00$0600000T50Y00Z
$00Y60000050$00Z00Y600000050Z0$0
0000600000500Z00$00600000050$000
00Z0600L0079999999980000005Y0$00
0$00600P00V000000V00000000500000
000060000000000000000000005Z0Y00
000060000000000000000000005000Z0
00$06000000000000WWW00000050Y0!0
00006000003111111111111111b00Y00
0Z0060000050$0Y00!0$0Y00Y0Y0Z!00
0000600000500$!00$00!0$0Y0!00Y00,50,10,1
