0000000000000000000000000000000~
0000000000000000000000000000000~
0000000000000000000000000000000~
000000000000000000000000000000W~
00000000000000000000000000031111
00000000K000000000K0000000050000
00000000000000000000000W00050000
00000000000000000000T31111450000
00000000000000000000079999850000
00000K00000000000000000000050000
00000000000K00000000000000050000
00000000000000000000000000050000
000000000000000W00W0000000050000
00000000000000311114000000050000
0000000000000T799998000000050000
0000000000000000UU00000000050000
00000000000000000000000000050000
00000000000000000000000000050000
000000000000000000000000W0W50000
00000000000WW000000000T311450000
00000000000311400000000799850000
0000WW00000799800000000000U50000
11111140000U00U00000000000050000
00000060000000000000000000050000,50,700,1
