0000000000000005000006000000000~
0000000000000005000006000000000~
11111111114000050000060000000005
00000000006000050000060000000W05
00000000006000050000060000031145
00000000006000050000060000T79985
00099999998000050000060000000005
0060000000U000050000060000000005
00600000000000050000060W00000005
006000T3114000050000063114000005
006000T7998000050000067998000005
00600031111111110000060000000005
09800050000000000000060000000005
60000050000000000000060000000W05
60000050000000000000060000031145
6000W050000000000000060000079985
60003450000000000000060000000005
600078799999999999aa980000000005
600000000U0000U000000U0000000005
60000000000000000000000000000005
60000000000000000000000000000005
800000000000W00000000000W0000005
0000000011111111111111111111111b
00000000000000000000000000000000,20,10,1
