00000000000000050000060000000000
00000000000000050000060000000000
11111111114000050000060000000005
00000000006000050000060000000005
00000000006000050000060000031145
00000000006000050000060000079985
00099999998000050000060000000005
00600000000000050000060000000005
00600000000000050000060000000005
00600003114000050000063114000005
00600007998000050000067998000005
00600031111111100000060000000005
09800050000000000000060000000005
60000050000000000000060000000005
60000050000000000000060000031145
60000050000000000000060000079985
60003450000000000000060000000005
60007879999999999999980000000005
60000000000000000000000000000005
60000000000000000000000000000005
60000000000000000000000000000005
00000000000000000000000000000005
0000000011111111111111111111111b
00000000000000000000000000000000
