0000000000000000000000000000000~
000000000L0000000000000000L0000~
00tu00000P0000000000000000P0000~
00vw000000000000000000000000000~
00vw0000rrrrrrrrrrrrrrrrrrrrrrrr
00vw0000000000000000000000000000
00xy0000000000000000$#0000000000
00000000000000000000Y!0000000000
0000000000000000000000X00X000000
rrrrrrrrrrrr0000000000X00X000000
0000000000000000000000X00X000000
0000$#000000000000L000X00X000000
000!"Y00000X00X000P000rrrr000000
00000000000X00X00000000000000000
000000L0000rrrr00000000000000000
000000P0000000000000000000000000
00000000000000000000000000000000
X0X000000000000000000000000N0000
rrr0000000X00X0000000000J0000000
0000000000X00X000000$#00000N0000
0000000000XQ0X000000!"Y000000000
0000000000rrrr000000000000000000
00000000000000000000000000000000
rrrru000000000000000000000000000,50,700,1
