00000000000000000000000000050000
00000K000K0000000000000000050000
0000000N00000J000000000000050000
000R0000J000N0000000000000050000
00K0000J000000000000000000050000
00000000000000000000000000050000
00000000000000000000000000050000
00000000000000000000000000050000
0000000000000WWW0W0WW00000050000
00000000000031111111400000050000
00000WW0000050000000600000050000
00003114000050000000600000050000
00007998000050000000600000079999
0000U0U0000T500000006000000V0000
00000000000050000000600000000000
00000000000050000000600000000W00
00000000000050000000600000003111
00000000000050000000600000W05000
00000000000050000000600003115000
3111111400005000000060WW05005000
00000006000050000000611111111111
00000006000050000000600000000000
00000006000050000000600000000000
00000006000050000000600000000000
