00000000`-````-``005000000000000
00N00000``--`````0T5000000000000
0000K000``````-`-0050N0R00000000
000R0J00`````````005000R00000000
00000000`-`-`-```005000000000000
00000000`-`````-`0T500000N000000
00000000`-````-``0T5000000000000
00000000```-`````007999999999999
00000000-````````0000UV0U00VU0V~
00000000``-`-`-``00000000000000~
00000000``````-``00000000000000~
00000000``````-``00000000000000~
00000000-``-``-``00000000000000~
u0000000-`-```-`-00000000000000~
w0000000``````-`-00000000000WW0~
Cu000000`-``-```-000000000033333
"w000000`````````000000000Tdcccc
sssssu00````-``-`0000000000d0000
""$00000`--````-`000000000050,00
"""Y0000-````-``-000L000322b0.00
""""Z000`````````000P00050000.00
""""ZW00`````-```0O0WW0050000.00
1111114<=========>31111111400/00
00U0006[]\[]\\[][\544444444^^]^^, 20, 700, 1
