oooooooooooooooooooooooooooooooo
6LZ000000000000L00000000000L000~
6PZ000000000000P00000W00000P000~
14000003111111111111111111111111
08000007999999999999999999999999
080000000000000000L0000000000005
0800000000000Z0000P0000000000005
08OO00000W0000000000W00000000005
01111111111111111111114000003111
00000000000000000000006000007aaa
00000000W00000000000006000000U00
00000000U00000000000006000000000
00000000000000000000006000000000
099999999999999999999980000#0003
c00000000000U0000U000000000Y0005
00000000000000000000000000000005
000000000000000000000000000L0005
000000000000000000000000000P0005
00L0000000000Y000000000000003115
00P00000000000000000000000005000
0000000000Y00000000000000QQ050W0
111400000000000000!Y0003111110U0
00060000000000000000000500000000
0006___________________500000000,50,700,1
