nnnnnnnnnnnnnnnnnnnnnnnnnnnnnnnn
00UU000000000000000000000000N000
0000LZ00000000000000000000000J00
0000Y000000000000000000000000000
fi000000000000000000000000000000
nm000000W00000000000000000000000
V0000hffi000LZ000000000000000000
00000lnnm000Y0000000000000000000
000000UV000000000000000000000000
00000000000000000000LZ0000000000
0000000000000hffi000Y00000000000
0000000000000lnnm000000000000000
00000000000000U00000000000000000
0000Y00L000000000000W0O0000LZ000
000Z""YP000000000000hffi000Y0000
000Z""Y0Z00000000000lnnm00000000
0000YY0ZYY000000000000V000000000
00000000000000000000000000000000
00000000000000000000000000000000
0000000000000000000000000000000h
0000000000000000000000000000000~
000000000000000000000000000000W~
00000000000000000000000000000hff
________________________________,25,100
