00005000000000000000000006000000
00005000W000#0000000000006000000
00005000U00y"Z000W0000000e000000
000T50000000Y0000U0000000e000000
0000500000000000000000000e000000
0000799999a9aa9a9aaaaa+aa8000000
00000000000V0000000000}U00000000
0000000000000000000000}000000000
0000000000000000000000}000000000
000000000000000000000J}000000000
0000000000000000000000}000000000
00000000N0000000000000}000000000
0000000000000000000000}000000000
0000000000000000000000}000000000
0000000000000000000000}000000000
0000000000000000000000}000L00000
0000000000000000000000}000PW0000
00000000000L0000311400}003224000
00000000000P00005%%600}005%Y60W~
000000000031400T5%%600}00500c111
00000000007980005%%600}005000000
00WW0000000U00005%%600}0T500$YZ0
11111114000000005%%600?00500!"00
%%%%%%%8________5%%6_____5000000, 30, 700, 1
