00006000000050005000000000000000
00006000000050005000000000000000
000060000000500050000!""!Y000000
0000600K00005000500000"0$0000000
00006000R00050005000000000000000
00006000000050007999999999999999
00006000000050000000000000000000
99998000000050000000000000000000
000U0000000070000000000000000003
0000000000000000000000000000000d
000000000000000000000000000000Td
00000000000000000000000L0034000d
00000000000000000000000P00780005
000000000000000000000000000V0005
000000$00000000000000340000000Td
0000Z"""!00000000000078000000005
00000!"Y0000000000000U0000000005
000000$00000000000000000WW000005
0000000000000000031111111111111b
000L0000000000000dY%%%0000000000
000P0000000000000500000000000000
0000W00O000000000500000000000000
11111111111400000d00000000000000
0000000000Z600000500000000000000,50,700
