0000000000000000000000000000000d
0000000000000000000000000000000d
000000000000000K000000000000000d
0000000000000000000000000000000d
0000000000000000000000000000000d
00000000000000WW00000000000000Td
0000000000000311140000000000000d
0000000000000d0"Ye0000000000000d
00000000000005000e0000000000000d
00000000000W0d000e0000000000000d
0000000000311b000e0000000000000d
000000000TdZ"0000e0000000000000d
00000000005000000e000000000000Td
00000000W0d000000e0000000000000d
0000000311b000000e0000000000000d
0000000d!"0000000e0000000000000d
00000005000000000e00000WW000000d
00000W0d000000000e^^^^311400000d
000T311b000000000)````{0%e00000d
0000d"""000000000)````{0%e00000d
0000d000000000000)````{0%e00000d
00005000000000000)````{00e00000d
1111b000000000000@::::&00e00000d
000000000000000000""$0000114000d, 20, 700
