00000000000000000000000000000000
000000000000000000000000N0000000
00000J00000000000000000000000000
00000000000000000000000000000000
00000000000000000N00000000000000
0000000000K000000000000000000000
00000000000000000000000000000000
00000000000000000000000000000000
00M00000000000M00000000000000M00
00P00000000000P00000000000000P00
000000000000000000000000000O000~
31214000000031214000000000031214
70%08000000T70%%800000000007%008
079800000000079800000000000T7980
00U00000000000U00000000000000V00
00000000000000000000000000000000
0000000000000R000000000000000000
00000000000000000000000000000000
00000000000K00000000000000000000
00000000000000000000000000000000
^^^^^^^^^^^^^^^^^^^^^^^^^^^^^^^^
````````````````````````````````
````````````````````````````````
````````````````````````````````, 30, 320, 1
