00000000000000000000000000000000
0000,000000000000000000000000000
0000.0000000000W0000000000000000
0000.000000tss111u00000000000000
0000/00000T5Y0000e00000000000000
^^^^[^^^^^^{00"00e0000000000L0L0
```````````{00000w0000000000P0P0
:::::::::::xzaaazy0W00000000000W
0000000000000V000U31su00000t1s11
000000000000000000x9z80000050000
0000000000000000000V000000T50000
000000000000000000000000000v0W00
000000000000000000000000000d0UY0
000000000000000000000000000v0000
000000000000000000000000000d0000
0000000000000000000311r1ssud0000
0000000000000000000500000Uw50000
0000000000000000000v000000ev0000
00000000000Tt11sss4v000W00ed0000
000W000000W0500000wd000U00wv0000
11r22u3s22r4vW0000wd00Z000e50000
0"000e50000wvU00006d00"000wv00V0
0!000wv00V06d0"!006d000000ev0000
000006v0000ed00000ev000000wd0000, 30, 650
