000000``0000000000000``000000000
000000``0000000000000``000000000
000000``0000000000000`-000000000
000000`-0000000000000``000000000
000000`-00000000000W0``00000W000
000000``00000Z00000U0``00000U000
000000``000!",Y000000``000000000
000000``0000Z.0000000-`000000000
00W000--00000.0000000-`000000000
00U000``00000.0000000``000000000
000000``00000.0000000`-000000000
000000``00000.0000000--000000000
000000`-00000.0000000``000000000
000000``00000.0000000``000000000
000000``00000.0000000`-00000L000
000000-`00$Z0.Y000000`-00000P000
000000``00Z"!."000000``000000000
00000<==>00Y0/!00000<==>0000tsss
^^^^^^][^^^^^\^^^^^^^]\^^^^^{000
````````````````````````````{000
````````````````````````````{000
````````````````````````````{000
````````````````````````````{000
````````````````````````````{000
