000000000000000000000m000000m000
000000000000000000000m000000m000
000000000000000000000m000000m000
000000000000000000000m000000m000
000000000000a00000000m000000m000
000000000000000000000m000000m000
!"#$%&'()*+,-./000000m000000m000
000000000000000000000m000000m000
000000000000000000000m000000m000
000000000000000000000m000000m000
000000000000000000000m000000m000
000000000000000000000m000000m000
000000000000000000000m000000m000
0000000000000040000700000000m000
0000000000000000000000000000m000
0000000000000000000000000000m000
000000000000000000000m000000m000
000000000000000000000m000000m000
000000000100000000000m000000m000
000000000000mmmmm0000m000000m000
000000000000000000000m000000m000
00000000A000000000000m000000m000
000000000000000000000m000000m000
mmmmmmmmmmmmmmmmmmmmmmmmmmmmmmmm
