0000000000000k00000000j000000000
0000000000000k000M0000lnnnnnnnnn
0000000000000k000P00000000000000
00$Z"Y0000000k000000000000000000
000""!0000000k00000000000$S0000~
000Y"!0000000k00000000hfffffffff
0000000000000k00000000j0!0000000
0000000000000k00000000j000000000
0000000000000k00000000j000000000
0000000000000k000M0000j000000000
0000000000000k000P0000j0Y0000000
0000000000000k00000000j000000000
0000000000000k00000000j000000000
0000000000000k00000000j000000000
0000000000000k00000000j000000000
0000000000#00k00000000j0000"0000
nnnnnnnnnnnnnm00000000j0000Y"000
000000000"Y000000M0000j000000000
000000000"0000000P0000j000000000
000000000"000000000000j000000000
000000000"000000000000j000000000
000000S00"000Q00000000j000000000
ffffffffffffffi0000000lnnnnnnnnn
00000000000000k00000000000000000,50,700, 1
