00000O00000000000000000000000000
03400311114003400000000000000000
078005000060078000000000000O0000
003405L00L6034000000000000033333
0078070000807800000R000000050000
000340dede03400000R00000000500W0
000780787807800000000000000500U0
00003403403400000000000000050000
00007807807800000000000000079999
00000324324000000000000000000000
0000079879800000000000000000W00~
00000314314000000000000000031111
00000798798000000000000000050000
00000003400000000000000000350000
00000007800000000000322224550000
000000000000000W000050000e550000
0000000000000032240050000e5d0000
0000000000000079980050000e550000
0000WW0000000000000T50000e5d0000
22222222222400000000799998550000
00000000000e00000000000V00550000
00000000000e000000K0000000550000
00000000000e00000000000000550000
00000000000e00000000000000550000, 30, 600, 1
