00000000000000000000000000000000
000000N0000000000000000000000000
0000000000000000000000000000J000
00000000000000000000000000000000
000000000000000hfi00hfi000000000
00000000000000Tj000000k000000000
000000000000000j0S0000k000000000
00000000000000hp000000qi00000000
0000000000000hp000S0000qi0000000
0000000000000j000000S000k0000000
0000000000000j0000000+00k0000000
000000000000hp00S0000}0Sqi000000
00000000000hp0+000000}000qi00000
0000000000hp00}00+0S0}0000qi0000
000000000hp0+0}S0}000}000+0qi000
00000000hp00}0}00}00+}000}00qi00
0000000hp000}0}00}00}}0S0}000qi0
000000hp0000}0}00}00}}000}0000qi
00000hp00S00}0}00}00}}000}00000k
0000hp000000?0?00?00??000?00000k
000hp___________________________
00hp}}}}}}}}}}}}}}}}}}}}}}}}}}}}
ffp}}}}}}}}}}}}}}}}}}}}}}}}}}}}}
}}}}}}}}}}}}}}}}}}}}}}}}}}}}}}}}, 30, 700
