00000000000000000000000000000000
0000000tsssssu000000000000000000
0000000v00000w000000000000000000
0000000v00000w0000L0000000000000
0000000xxxxxxy0000P0000000000000
0000000000000tru000000trrrru0000
00000R0000000v0w000000v0000w0000
0000K00000000v0w000000xxzzyy0000
0000000000000v0w000tru,v00w00000
0000000000000v0w000v0w.v00w00000
0000000000000v0w000v0w.v00w00000
0000000000000xzy000v0w.v00w00L00
00000L0000000000000v0w.v00w00P00
00000P0000000000000v0w.v00w00000
0000000000000000000xzy.v00w00000
0000000000tssrrrrru000.v00w00000
0000000000xx0000yyy000.v00w00000
000000000000v00w000000.v00w00000
000000000000v00w000000.v00w00000
000000000000v00w000000.v00w00000
000000000000v00w000000/v00w00000
00000'000000v00w^^^^^^\v00w0000~
rrrrrru00000v00w```````v00w00tsu
000000w00000v00w```````v00w00v00
000000w00000v00w```````v00w00v00, 30, 680, 1
