oooooooooooooooooooooooooooooooo
k00000000Y00000000000000000X00X0
k0000000000L000000000000000X00X0
k0000000000P000000000000000X00X0
k00001111111111111111111114X00Xh
k0000000000000000L00000005600LXj
k0000000000000000P00000005600P0j
k111111111111111111110000560000j
k0000000L0000000000000000560000j
k0000000P000000000Y000000560Z00j
k000011111111111111111111560000j
k00000000000000000L000000560000j
k0000000000Z000000P00000056L000j
k11111111111111111111000056P000j
k000000L00000000000000000560000j
k000000P00000000000000000560000j
k000011111111111111111111560000j
k000000000L00000000000000560000j
k000000000P00000000000000560Y00j
81111111111111111111100007800L0j
000000L00000Z000000000000UU00P0j
000000P000000000000000000000Z00j
1111111111111111111111111400000j
00000000000000000000000006_____j,50,700
