000000000000000000j000k00000000~
000000000000000000j000k00000000~
0J00J000000J000000j000k00J000QS~
00000000N000000000j000k00000hfff
000000000000000000j000k00000lnnn
00S0000000S0000000j000k000000000
hfi0000hfffi000000j000k000000000
j0k0N00j000k00000Nj000k000000000
j0k0000j000k000000j000k000000000
j0k0000j000k000000j000k000000N00
j0k0000j000k000000j000k000000000
j0k0000j000k0SQ000j000k000000000
j0k0000j000khffi00j000k000000000
j0k0000j000klnnm00j000k000000000
lnm0000j000k000000j000k000000000
0000000j000k000000j000k000000000
0000000j000k000000lnonm000000000
0000000j000k00000000000000000000
0000000j000k00000000000000000000
0S00S00j000k00000S0000000'000S00
ffffffffffffffffffffffffffffffff
00000000000000000000000000000000
00000000000000000000000000000000
00000000000000000000000000000000,20,600,1
