0000000000000000000000000000000~
000000000000000K00000000000000W~
0000000R000000000000000000000314
00000000000000000000R0000J0007a8
00000000000000000000000000000000
00O0000000W0000000WWWW'000000000
03400000003400000031114000000000
05600000005600000050006000000000
05600000005600J00050006000000000
07800000007800000050006000000000
0VU000K000UU00000050006000000000
0000000000000000007aaa8000000000
000000000000000000U000U000000000
00000000000000000000000000000000
0000000000000J000000000000000000
00000000R00000000000K00000000000
0000000000000000000000000J000000
00000000000000000000000000000000
00000000000000000000000000000000
00000000000000000000000000000000
00W0'000000000000000000000000000
31114000000000000000000000000000
50006000000000000000000000000000
50006000000000000000000000000000,20,600,1
