00000000000000000000000000000000
000000000000000R000000000000000~
0000K000K000K000000W0W0WWW00W00~
000000000000000T3111111111111111
00000000000000007aaaaaaaaaaaaaaa
00311140000000000U00000U00000000
007999800R0000R00000K00000000000
000V000000000000000000000000K000
00000000000000000000000R00000000
00000000000000000000000000000000
00000000000000000000R00000000000
0000K0000O0W00000000000000000K00
00000000031114000000000000000000
00000000T79998000000000000000000
0000000000R00U000000003114000000
00000000000000000000007aa800000W
0000000000000000000000000U000003
00000000000000000000000000000005
00000000000000000000000000000005
000000000000K000000K000000000007
00WW000000000000000000000000000U
31212400000000000000000000W00000
22222600000000000000000T31114000
2222260000000000000000007aaa8000,20,600
