0000X0X000000K000000000000000000
0000X0X0000000000000000000000000
0000X0X000000000000000000000000~
000NX0X00000000000000000qgi0000~
0000X0X000000hfi000000000Vjqpqpp
0000rsr000000j"k0000000000lnop""
0000000000000j"k0000000000U0Uj""
0000000000000lom0000000000000j""
00000000000000V00000000000000j""
00000000000000000000000000000j""
000000hgi000SSSSS00000000N000j""
000000j"qfgi00000hfgfgi000000j""
000000j""""q00000p""""k000000j""
000000lnonom00000lnop"k000000j""
000000UU0U0000000000j"k000000j""
00000000000000000000j"k000000j""
00000000000000000QSSj"k000000j""
0000K000000000000h00lnm000000j""
00000000000000000j000V00000WWj""
00000000000000000j000000000hfp""
0000000000hfifg00j000000000j""""
0000000000j"k0000j000000000j""""
ffffi00000j"k00fgjfgi000000j""""
""""qfffffp"k^^^^j00qfgfgfgp"""",50,700
