0000000000000000000v"w000000X000
0000000000000000000v"w00L000X000
0000000000000000000v"w00P000X00~
000000L000000000000v"w000000X00~
000000P000000000000v"w000rr0X0rr
0000000000000000000v"w000000X000
000000000000000000$v"w000000X000
000000000000000000Yv"w000trru000
0000000000000000000v"w000v"w0000
0000000000000000000x"y000v"w0000
00000000000000000000X0000v"w0000
0000$#000000000000L0X0000v"w0000
000!"Y0tru00000000P0X0000v"w0000
0000000v"w000tru000rrrrrrrrr0000
000P000v"w000v"w0000000000000000
000L000v"w000v"w0000000000000000
0000000v"w000v"w0000000000000000
0000000v"w000v"w000000000000N000
0000000x"y000v"w000000000J000000
00000000X0000v"w00000$#00000N000
00000000X0000v"w00000!"Y00000000
00000000X0000v"w0000000000000000
00000000rrrrrrrr0000000000000000
rru00000000000000000000000000000,50,700
