00X0X0000X0X0000X0X00000X0X00000
00X0X0000X0X0000X0X00000X0X00000
00X0X0000X0X0000X0X00000X~X00000
00X0X00N0X0X0000X0X00000X~X00000
00X0X0000X0X0000X0X00000sss00000
00X0X0000X0X0000X0X0000000000000
00X0X0000XQX0000X0X0000000000000
00X0X0000tsu0000X0X0000000000000
00X0X00000000000tsu0000000000000
00tsu000000000000000000000000000
00000000000000000000000000000000
00000000000000000000000000000000
0000000WW0000WWWW000000000000000
000000hffi00hffffi0000000WWWW000
0WWWWWjqpk00jqpqpk000000hfgfgi00
hfgfgfpqpk00jqpqpk000000jqpqpk00
loooooooom00loooom000000lqpqpm00
00000000000000000000000000000000
0000000WW0000WWWW000000000000000
000000hgfi00hffffi0000000WWWWWWW
000000jqpkWWjqpqpk000000hfffffff
000000jqpqffpqpqpk000000jqpqpqpq
WWWWWWjqpqpqpqpqpkWWWWWWjqpqpqpq
hffffgpqpqpqpqpqpqfgfgfgpqpqpqpq,50,700
