X00X0000000X000X00000000X0000X0X
X00X0000000X000X00000000X0000X0X
X00X03111114000321212140X0000314
X00X38000000000X00000074X0000000
X0038X000000000X0000000540000000
X0000X000000000X0000000000000000
X0000X000000000X0000000000000000
40000X000000000X0000000000000000
74000X000000000X0000000000000000
07400X000000000X0000000000000000
00740X000000000X0000000000000000
000714000000000X0000000000000000
0000X0000000000X0000000000000000
0000X0000000000X0000000000000000
0000X0031111140X000000hfi0000000
0000X0380000071400000hqpqi000000
0000X380000000000000hqqpppi00000
0000380000000000000hppqppqqi0000
000070000hfi00000hfpppqqpqpqi000
00000000hkkki000hpqppqqpqqpqpi00
0000000hjjkkm000jqpqqqpqqpqqqpi0
000000hjjkkkm000jpqqqqpqqqqqppqi
00000hjjjjjm0000lqqqqpqqpqpqpqpp
fi++hlpjjjm++++++lpqpqqpqppqqqqq,50,700
